11111111111111111111111111111
110000000000000000000P00E0001
10011000000000000000000000001
1011100000000000000000E000001
11111111111111111111111111111