11111111111111
10000000p00001
10100p00101101
11111111111111