11111111111111111111
10000000000000000001
10010000000000100001
10010001000000100001
10000100010001000101
10100000000100001001
11111111111111111111