11111111111111111111
10c000c0000c000c0001
1e000000p00000000001
100000000c000c000c01
10010010000000000001
100000100c000c000c01
100000c0111001100101
10010000101100110001
10c10001010001000101
10010000010001000101
11111111111111111111