11111111111111111111
1000000000000c000001
10000000000000000001
10000000000000000001
100000000p0000000001
10000000000000000001
10000000000000000001
1e000000000000000001
11111111111111111111